                                                        
   #              #                                                                          
   #                      #                                        
		########                                                          
		#		      	                                 
		#			                                 
		                                               
      ########                                                    
      #			#		
      #             #   #                                                      
      #             	#                   
      			#	        
      	       ####	                                                 
      #		####               
      #
      		 	
