########################################
#                                      #
#                                      #
#       ##                  ##         #
#       ##                  ##         #
#       ##                  ##         #
#       ##                  ##         #
#       ##                  ##         #
#       ##                  ##         #
#       ##                  ##         #
#                                      #
#                                      #
#    T                                 #
#                                      #
########################################

      		 	
