                                                                                             
   #              #                                                                          
   #                      #                                        
		########         ####                                               
		#		#    #  	                                 
		#		#    #	                                 
		       T        #    #                           
      ########                                                    
      #			#	   #	
      #             #   #         #                                             
      #             	#        #           
      			#	        
      	       ####	                                                 
      #		####        ######       
      #
      		 	
